tmap
8888888888888888888888888888888
8888877777777777777777788888888
7777777733333333333777777777777
3333333333333333333333333333333
3333311111111111111111113333333
1111111111111111111111111111111
1111111111111111111111111111111
7777777777777777777777777777777
8888888888888888888888888888888
1111111111111111111111111111111
2222222222222222222222222222222
3333333333333333333333333333333
4444444444444444444444444444444
5555555555555555555555555555555
6666666666666666666666666666666
7777777777777777777777777777777
8888888888888888888888888888888
1111111111111111111111111111111
omap
1000 0 100 100 collider monster_front.png 0 0
1000 0 100 100 collider monster_front.png 50 100