tmap
8888888888855555555555888888888
8888888888888555555558888888888
8888888877777755557778888888888
8887777773333333333377788888888
7777333333333333333333777777788
7333333333111111111333333333778
3333333111111112221113333333337
3331111111111124442111111111333
1111111111111244442111111111113
1111111111111124421111111111111
3111111111111112211111111111111
3331111111111111111333333333111
3333331113311133333333333333333
7773333333333333333333777777733
8877777333337777777777788888777
8888887777777888888888888888888
8888888888888888888888888888888
8888888888888888888888888888888
omap
1000 0 100 100 collider monster_front.png 0 0
1000 0 100 100 collider monster_front.png 500 100