888888888888888888888888888888
888888888888888888888888888888
777777777777777777777777777777
333333333333333333333333333333
111111111111111111111111111111
111111111111111111111111111111
111111111111111111111111111111
777777777777777777777777777777
888888888888888888888888888888
111111111111111111111111111111
222222222222222222222222222222
333333333333333333333333333333
444444444444444444444444444444
555555555555555555555555555555
666666666666666666666666666666
777777777777777777777777777777
888888888888888888888888888888
111111111111111111111111111111